############### 
# aaa  @      #
# #########   #
# #       #   #
# #  a   a#   #
# #       #   #
# #   1       #
# #  a    #   #
# #     a #   #
# #       #   #
# #########   #
#     x       #
#             #
#             #
###############