############### 
# aaa  @      #
# #########   #
# #       #   #
# #  a   *#   #
# #       #   #
# #    2      #
# #  a    #   #
# #     a #   #
# #       #   #
# #########   #
#     x       #
#             #
#   e    r    #
###############