############### 
#      @      #
#             #
#             #
#             #
#             #
#             #
# 2           #
#             #
#         x   #
#             #
#             #
#             #
#             #
###############